OU

PRONUNCIATION
The digraph OU represents one sound:
• /u/ — as in "moon"
/ər/ OU + R
/w/ 
/æʊ/

EXAMPLES
    route
    cocoon -> cocoune
    baboon -> baboune
    kangaroo -> cangarou
    soup → soupe 
    fool → foule
    stool → stoule
    boom → boume
    room → roume
    soon → soun
    moon → moune
    loom -> loume
    loon → loune
    coop → coupe
    stoop → stoup
    loot → loute
    tomb → toume
    rune -> roune

turn → tourne
nurture → nourțure

where  → ouere
wet -> ouet

to power -> to pouir
to tower -> to touir
to flower -> to flouir
flour -> flouar
coward -> couard
vowel -> vouale
fowl -> fouale


TEACHING NOTES
OU consistently represents /u/. It replaces English "oo" when pronounced /u/.
