Comparative and Superlative Adjectives in Inglisce

Inglisce forms comparatives and superlatives using -ar and -est (derived from Old English -ra and -est), unlike Modern English's -er and -est.


Formation Rules:

 1. One-Syllable Adjectives
Pattern: Add -ar (comparative) and -est (superlative)

Regular examples:
- small → smallar → smallest
- tall → tallar → tallest
- oît → oîtar → oîtest
- ôld → ôldar → ôldest
- sad → sadar → sadest
- smart → smartar → smartest

Adjectives ending in -g:
When the vowel is long, the ending adjusts:
- Long vowels + ng: Add -u before the ending
  - stròng → stròngar → stronguest
  - lòng → lòngar → longuest
  
- Short vowels after g: Add -h before the ending  
  - big → bigar → bighest
  - yong → yongar → yonghest

- Words ending in -c: Add -qu before the superlative ending
  - pinc → pincar → pinquest
  - blac → blacar → blaquest

 2. Two-Syllable Adjectives
Default: Use analytical forms with more/moast

Exception: Adjectives ending in -o can take -ar/-est with -u- insertion:
- nâro → nârouar → nârouest
- sloe → slouar → slouest

 3. Adjectives Ending in -y
Pattern: Change -y to -iar (comparative) and -iest (superlative)
- pritty → prittiar → prittiest
- lîvely → lîveliar → lîveliest
- daidly → daidliar → daidliest
- míty → mítiar → mítiest
- ângry → ângriar → ângriest

 4. Multi-Syllable Adjectives
Pattern: Always use more/moast
- more sîlent → moast sîlent
- more cairful → moast cairful
- more clever → moast clevre
- more sevire → moast sevire
