The Suffix -ment in Inglisce

The suffix -ment (from French) forms nouns from verbs, indicating the action, result, or state of the verb.

1. Regular Formation (No Change)

Most verbs simply add -ment without any changes to the stem:
  achive → achivement
  adorne → adornement
  advertyse → advertysement
  ajoste → ajostement
  amâse → amâsement
  amuse → amusement
  comitte → comittement
  confîne → confînement
  disbare → disbarement
  empeire → empeirement
  encoûrage → encoûragement
  engâge → engâgement
  excîte → excîtement
  improuve → improuvement
  installe → installement
  investe → investement
  manage → management
  nourișe → nourișement
  paie → paiement
  ponișe → ponișement
  replâce → replâcement


2. Stem Changes Before -ment

Certain verbs undergo stem modifications when adding -ment:

a) Verbs that drop the final -e:
  conteine → contéinment 
  entreteine → entretéinment 
  govirne → govirnment 
  deploie → deploiment
  emploie → emploiment
  enjoie → enjoiment

Note: The accent marks in the derived forms (contéinment, entretéinment) mark the stress in the new word formation.
entreteine + ment = entretéinment
govirne + ment = govirnment

b) Some verbs show vowel changes or simplification:
  agríe → agríment (í remains, e drops)
  defêr → defêment (r drops)
  devèlope → devèlopment (final e drops)
